9 9 9 9 9 9 9 9 9 9 9 9 9 9 9 9 9 9 9 9 9 9 9 9 9 9 9 9 9 9 9 9 9 9 9 9 9 9 9 9 9 9 9 9 9 9 9 9 9 9 
9 9 9 9 9 9 9 9 9 9 9 9 9 9 9 9 9 9 9 9 9 9 9 9 9 9 9 9 9 9 9 9 9 9 9 9 9 9 9 9 9 9 9 9 9 9 9 9 9 9 
9 9 7 7 7 7 7 7 7 7 7 7 7 7 7 7 7 7 7 7 7 7 7 7 7 7 7 7 7 7 7 9 9 9 9 9 2 2 7 7 7 7 7 2 2 2 9 9 9 9 
9 9 7 8 8 8 8 8 7 7 7 7 7 7 7 7 7 7 7 7 7 7 7 7 7 7 7 7 7 7 7 7 7 7 9 9 9 7 7 7 7 7 7 7 2 2 9 9 9 9 
9 9 7 8 1 1 1 8 7 7 7 7 7 7 7 7 7 7 7 7 7 7 7 7 7 7 7 7 7 7 7 7 7 7 9 9 9 2 2 2 2 7 7 7 7 2 9 9 9 9 
9 9 7 8 1 1 1 8 7 7 7 6 6 6 6 6 6 6 6 6 6 6 7 7 7 7 7 7 7 7 7 7 7 9 9 9 9 9 2 2 2 7 7 7 7 2 2 9 9 9 
9 9 7 8 8 1 8 8 7 7 6 6 7 7 7 7 7 7 7 7 7 6 6 6 7 7 7 7 7 7 7 7 6 0 0 0 0 0 2 2 2 7 7 7 7 2 2 2 9 9 
9 9 7 7 2 2 2 7 7 7 6 7 7 7 7 7 7 7 7 7 7 7 7 6 6 7 7 7 7 7 7 6 6 9 9 9 9 9 2 2 2 7 7 7 7 7 2 2 9 9 
9 9 7 7 2 2 2 7 7 7 6 7 7 7 7 7 7 7 7 7 7 7 7 7 6 6 6 7 7 7 7 6 7 7 7 7 7 7 7 7 2 7 7 7 7 7 7 7 9 9 
9 9 7 7 7 2 2 7 7 7 6 7 7 7 7 7 7 7 7 7 7 7 7 7 7 7 6 6 6 6 6 6 7 7 7 7 7 7 7 7 7 2 2 2 2 2 2 7 9 9 
9 9 7 7 7 6 6 6 6 6 6 7 7 7 7 7 7 7 7 7 7 7 7 7 7 7 6 7 7 6 7 7 7 7 7 7 7 7 7 7 2 2 8 8 1 8 8 7 9 9 
9 9 7 7 7 6 7 7 7 7 7 7 7 2 2 2 2 7 7 7 7 7 2 2 6 6 6 7 7 6 6 7 7 7 7 7 7 7 7 7 2 2 8 1 1 1 8 7 9 9 
9 9 7 7 7 6 7 7 7 7 7 7 7 2 2 2 2 7 7 7 7 7 2 2 6 2 7 7 7 7 6 7 7 7 7 6 6 6 7 6 2 2 8 1 1 1 8 7 9 9 
9 9 7 7 6 6 7 7 7 7 7 7 7 2 2 2 2 7 7 7 7 7 7 2 6 2 7 7 7 7 6 6 6 7 7 6 7 6 7 6 2 2 8 8 8 8 8 7 9 9 
9 9 7 7 6 7 7 7 7 7 7 7 7 7 2 2 7 7 7 6 6 6 7 6 6 7 7 7 7 7 7 7 6 6 7 6 7 6 6 6 7 7 7 7 7 7 7 7 9 9 
9 9 7 7 6 6 7 7 7 7 7 7 7 7 2 2 2 7 6 6 7 6 7 6 7 7 7 7 7 7 7 7 7 6 6 6 7 7 7 7 7 7 7 7 7 7 7 7 9 9 
9 9 7 7 7 6 6 6 6 6 7 7 7 7 6 6 6 6 6 7 7 6 6 6 7 7 7 7 7 7 7 7 7 7 6 7 7 7 7 7 7 7 7 7 7 7 7 7 9 9 
9 9 7 7 7 7 7 7 7 6 6 6 7 7 7 7 6 6 7 7 7 7 7 7 7 7 7 7 7 7 7 7 7 7 6 7 7 7 7 7 2 2 7 7 7 7 7 7 9 9 
9 9 9 7 7 7 7 7 7 7 7 6 7 7 7 7 6 6 6 6 7 7 7 7 7 7 7 7 7 7 7 6 6 6 6 7 7 7 7 7 2 2 7 7 7 7 7 7 9 9 
9 9 9 7 7 7 7 7 7 7 7 6 6 7 7 7 7 7 7 6 7 7 7 7 7 7 7 7 7 6 6 6 7 7 7 7 7 7 7 7 2 7 7 7 7 7 7 7 9 9 
9 9 9 9 9 9 9 9 7 7 7 7 6 6 6 7 7 7 7 6 7 7 7 7 7 7 7 7 7 6 7 7 7 7 7 7 2 2 2 2 2 2 7 7 7 7 7 7 9 9 
9 9 7 7 7 7 9 9 9 9 7 7 7 7 6 6 7 7 7 6 6 7 7 7 7 7 6 6 6 6 7 7 7 7 2 2 2 2 2 2 2 2 2 2 2 2 7 7 9 9 
9 9 7 7 7 7 9 9 9 9 9 7 7 7 7 6 6 6 7 7 6 7 7 7 7 6 6 7 7 7 7 2 2 2 2 2 2 2 2 7 7 2 2 2 2 7 7 7 9 9
9 9 7 7 7 7 9 9 9 9 9 2 2 7 7 7 7 6 6 6 6 7 7 7 7 6 7 7 7 7 6 2 7 7 2 2 2 2 2 7 7 7 2 2 2 7 7 7 9 9
9 9 7 7 2 2 9 9 9 9 9 2 2 2 7 7 7 7 6 7 6 7 7 7 2 6 2 6 6 6 6 7 7 7 2 2 2 2 2 7 7 8 8 1 8 8 7 7 9 9
9 9 7 7 2 2 0 0 0 0 0 2 2 2 2 2 7 6 6 7 6 7 7 6 6 6 6 6 7 7 7 7 7 7 7 2 7 7 7 7 7 8 1 1 1 8 7 7 9 9
9 9 7 7 2 2 0 0 0 0 0 6 6 6 6 6 6 6 7 7 6 6 6 6 2 6 2 7 7 2 2 2 7 2 2 2 2 7 7 7 7 8 1 1 1 8 7 7 9 9 
9 9 7 7 2 2 9 9 9 9 9 6 2 2 7 7 7 7 7 7 7 7 7 7 7 6 7 7 7 7 2 2 2 2 2 7 2 2 2 7 7 8 8 8 8 8 7 7 9 9 
9 9 7 7 7 7 9 9 9 9 9 6 2 7 7 7 7 7 7 7 7 7 7 7 7 6 7 7 7 7 2 2 2 2 7 7 7 7 2 2 7 7 7 7 7 7 7 7 9 9 
9 9 7 7 7 7 9 9 9 6 6 6 7 7 7 7 7 7 7 7 7 7 7 7 6 6 7 7 7 7 7 7 7 7 7 7 7 7 7 2 7 7 7 7 7 7 7 2 9 9 
9 9 9 9 9 9 9 7 7 6 7 7 7 7 7 6 6 6 7 7 7 7 7 6 6 7 7 7 7 7 7 7 7 7 7 7 7 7 7 2 7 7 7 7 7 7 7 2 9 9 
9 9 7 7 7 7 7 7 7 6 6 7 7 7 7 6 7 6 7 7 7 7 7 6 7 7 7 7 7 8 8 8 8 8 8 8 8 8 8 8 8 8 8 8 8 8 8 8 9 9 
9 9 2 7 6 6 6 6 7 7 6 7 7 7 7 6 7 7 7 2 6 2 7 6 7 7 7 7 7 8 3 3 3 3 5 3 3 5 3 4 4 4 3 3 4 3 3 8 9 9 
9 9 2 6 6 7 7 6 6 6 6 6 6 7 7 6 7 7 7 2 6 6 6 6 6 7 7 7 7 8 3 3 3 3 3 3 3 3 3 3 3 4 3 3 4 3 3 8 9 9 
9 9 2 7 7 7 7 7 7 6 7 7 6 6 7 6 7 7 7 2 6 2 7 7 6 7 7 7 7 8 3 5 5 3 3 4 4 3 3 3 5 3 3 3 3 4 4 8 9 9 
9 9 7 7 7 7 7 6 6 6 7 7 7 6 6 6 7 7 7 6 6 7 7 7 6 6 7 7 7 8 3 3 5 5 3 3 4 3 3 3 3 3 5 5 3 3 3 8 9 9 
9 9 7 7 7 7 7 6 7 7 7 7 7 7 7 7 7 7 6 6 7 7 7 7 7 6 7 7 8 8 3 3 3 3 3 3 3 3 3 4 4 3 5 5 3 4 4 8 9 9 
9 9 7 7 7 7 7 6 6 7 7 7 7 7 7 7 7 7 6 7 7 7 7 7 7 6 6 6 6 6 3 3 4 3 3 3 5 5 3 4 4 3 3 3 3 4 4 8 9 9 
9 9 7 7 7 7 7 7 6 7 7 7 7 7 7 7 8 8 1 8 8 7 7 7 7 7 7 7 8 8 3 4 4 3 3 3 3 5 3 4 3 3 3 3 3 3 3 8 9 9 
9 9 7 7 7 7 7 7 6 6 7 7 7 7 7 7 8 1 1 1 8 7 7 7 7 7 7 7 7 8 3 4 3 3 3 4 3 3 3 3 3 3 4 4 4 3 3 8 9 9 
9 9 7 7 7 7 7 7 8 6 8 7 7 7 7 7 8 1 1 1 8 7 7 7 7 7 7 7 7 8 3 3 3 3 3 4 4 3 3 3 3 3 3 3 3 3 3 8 9 9 
9 9 8 8 8 8 8 8 8 6 8 8 8 8 8 8 8 8 8 8 8 8 8 8 8 8 8 8 8 8 3 3 3 3 3 3 3 3 3 3 4 4 4 4 3 4 4 8 9 9 
9 9 8 3 3 3 3 4 4 3 3 4 4 3 3 3 3 3 3 3 3 3 4 3 3 3 3 3 3 3 3 3 3 3 3 3 3 3 3 3 4 4 4 4 3 4 4 8 9 9 
9 9 8 3 4 3 3 3 4 4 3 3 4 3 3 3 4 4 3 4 4 3 3 3 3 4 4 3 3 3 3 3 5 5 3 3 4 4 3 3 4 4 8 8 3 8 8 8 9 9 
9 9 8 3 3 4 3 3 3 4 4 3 4 3 3 3 3 4 4 3 4 4 4 4 4 4 4 3 3 3 3 3 5 5 3 3 4 4 4 3 4 4 8 3 3 3 8 8 9 9 
9 9 8 4 3 4 4 3 3 3 3 3 3 3 3 3 3 3 4 3 3 4 3 3 4 3 3 3 3 3 4 4 3 3 4 3 3 3 3 3 4 4 8 3 3 3 8 8 9 9 
9 9 8 4 3 3 3 3 3 3 3 3 3 3 3 3 4 3 3 3 3 3 3 3 3 3 4 3 3 3 3 3 3 3 4 4 3 3 3 3 4 4 8 8 8 8 8 8 9 9 
9 9 8 8 8 8 8 8 8 8 8 8 8 8 8 8 8 8 8 8 8 8 8 8 8 8 8 8 8 8 8 8 8 8 8 8 8 8 8 8 8 8 8 8 8 8 8 8 9 9 
9 9 9 9 9 9 9 9 9 9 9 9 9 9 9 9 9 9 9 9 9 9 9 9 9 9 9 9 9 9 9 9 9 9 9 9 9 9 9 9 9 9 9 9 9 9 9 9 9 9 
9 9 9 9 9 9 9 9 9 9 9 9 9 9 9 9 9 9 9 9 9 9 9 9 9 9 9 9 9 9 9 9 9 9 9 9 9 9 9 9 9 9 9 9 9 9 9 9 9 9 
